0,22.31,-0.12
90,0,0
   BBBBBBB   
 UBUBUBUBUBU 
 BBBBBBBBBBB 
BUBUBUBUBUBUB
BBBBBBBBBBBBB
BUBUBUBUBUBUB
BBBBBBBBBBBBB
BUBUBUBUBUBUB
 BBBBBBBBBBB 
 UBUBUBUBUBU 
   BBBBBBB   